R   1980  1020
SO ./pictures/wood.xpm
WE ./pictures/redbrick.xpm
S ./pictures/dog.xpm
C 200, 20, 60
F 0,100,12
EA ./pictures/stone.xpm
NO ./pictures/hexagone.xpm
         111111111  1111111111111
        1000000000110000000000001
        10110002001110000020000001
        1021000000000000000000001
111111111011000001110000000000001
1000000000110000011101111101101111111111
1111011111111101110000001000002000000021
1111011111111101110101001000000000000001
1100000011010101110000001000000000000021
100000002000000001100000012000000000000011111111111
1000000000000002000000000100000N0000000000000000001
1100000111010101111101011000000000000000011111111111
11110111 1110101 1011010120000000002000111
11111111 1111111 11111111110001111111111
                           101
                           101
                           101
                           101
111111111111111111111111111101111111111111111111111111111111111111111111111111111111111111111111111111111111111111111111111111
1000000000000000000000000000000000000000000000000000000000000000000000000000000000000000000000000000000000000000000000002000001
111111111111111111111111111111111111111111111111111111111111111111111111111111111111111111111111111111111111111111111111111111
